                           !
 ~#  E~#~  ~    ~#    #~   !
~ #  ~ # ~  ~  ~E#~   # ~  #
$ # ~  #  ~   ~  # ~  #  ~ #
  #~  ~#   ~ ~ $ #  ~$#   ~#
#~   ~ #~   ~  ~ #$  ~#  $ #
# ~   ~#$  ~$~   #~~~~~~ ~  
#~ ~ ~ #~ ~~# ~  #  ~   # ~ 
#   ~E # ~  #  ~ #     ~#  ~
#~ $ ~ #~ ~ #$  ~#    ~ #  $
# ~#  ~  ~ ~#~ ~ #~  ~  #  ~
#~ # ~ ~    # ~ ~$ ~    # ~ 
# ~#    ~~~~#~   ~  ~~~~#~  
   #  P $          $    #   
