 !                       !  
O!  ###################  !O 
O!  # ###    #   ##   # E!O 
OOOO# ### ## # ## # ###OOOO 
O   # ###$## #$## # $ #   O 
O E # ### ## # ## # ### E O 
OOOO# $ #    #   ##   #OOOO 
########################### 
#   # # # ## # ## #   #   # 
#$# # # #  # #  # # ### # # 
#  ## #$# #$ #$# $#$  #$ ## 
# # # # # ## # ## # ### # # 
# # #$ P# ## # ## #   # # # 
########################### 
