     !                    !O
OOOO !~~~~~~~~~~          !O
O $ O#  $ E     OOOO OOO O#O
OOOOOOOOOOO#OOOOOOOO OOO O#O
O    OOOOOO#OOOOO$$O OOO$O#O
O    OOOOOO#OOOOOOOOOOOOOO#O
O    O    $#    $  E   $ O#O
O    OOO#OOOOOOO#OOOOOOO#O#O
O   $OOO#       #OOOOOOO#O#O
O#OOVO  # P     #  OO   #O#O
O#OOVO#OOOOO#OOOOOOOO$$ #O#O
O#OOVO#OOOOO#OOOOOO$OOOOOO#O
O#E   #OO$OO#    $  E     #O
OOOOOOOOOOOOOOOOOOOOOOOOOOOO
