X   X
X!P X
X O#X
X#O$X
XXXXX
