X     X
X!P   X
X#OOO X
X#O O#X
X#O O$X
X#OOO X
X#O O#X
X#O O$X
X#OOO X
XXXXXXX
