X       X
X    P!XX
XOX#OO#XX
X$  OO# X
X~OOOO #X
X$OO OO#X
X  OOOO#X
X #OO #XX
XXXXXXXXX
