X        X
XXX !    X
XXP#$#OO$X
X # O$#OVX
X# OOO$~OX
X#OO OO$~X
X# OOO O$X
XX# O#  OX
XXXXXXXXXX
