X      X
X! P   X
X#OO#OOX
X# O OOX
XO#OOO$X
XOO#O$ X
XOO#O  X
XXXXXXXX
