X     X
XP !  X
XOO#OOX
XOO#OOX
XOO#OOX
XO# O$X
X# O OX
XXXXXXX
