              
XXXXXXXXXXX P#
XXXXXXXX   #XX
XXX     #OOOXX
XX ##OOO O#OXX
XX#  O#OOO$OXX
X #OOO O#O OX$
X!XX#OOX$O# E#
X!X$ O#XXXXXEX
X#XXX#XXXXX#XX
X# XXXX   XXVX
X#OX  X#O$X  ~
X#O~#O~#O X#XV
X#O #O #O X#EV
