X       X
X     P!X
XO#OOOO#X
XO O OO#X
X$OO#OO#X
X #O$OOOX
XXXXXXXXX
