X      X
X   P# X
X OO# OX
X OO #OX
X OO# OX
X OO #OX
X$ O# OX
X OO~O#X
X #O O$X
XXXXXXXX
