X     X
X  #  X
XP# OOX
X# OOOX
X#OOO$X
X#OO$OX
XXXXXXX
