X     X
X!PXXXX
X#O XXX
X#OO XX
X#OOO X
X#O OXX
X# OXXX
X#OOOXX
X#OO  X
X#OOO$X
X#OXO X
X#O OOX
X#O X$X
X#OO  X
