X      X
XOOOO#PX
XOOO #OX
XOOO# OX
XOO #OOX
XOO# OOX
XO #OO$X
XO# OO$X
X #OO$OX
X# OO$OX
XXXXXXXX
