X    X
X!P  X
X OO#X
X#OO X
X$OO#X
XXXXXX
