X        X
X      P!X
XOOO#OOO#X
XO O O O#X
XOOO#  O#X
XO$  OOO#X
XO O#O O#X
XOOO OOO#X
XXXXXXXXXX
