X       X
X   XXX!X
X#X   X#X
X#XOOOX#X
X#POOXX#X
XXXXO $#X
XXXXXXXXX
