X     X
X!P~  X
X#O O$X
X#OOO X
X$O#O X
XXXXXXX
