X    X
X! P X
X#OOOX
X#OO X
X#OOOX
X# OOX
X#OO$X
X#OO X
XXXXXX
