X    X
X P !X
XOOO#X
XO#O#X
XO O#X
XOOO#X
X$O# X
X O #X
X OO#X
XXXXXX
