   P   E   E   E   E   E    
OOO#OVO#OOO#OVO#OOO#OVO#OOO#
OOO#OVO#OOO#OVO#OOO#OVO#OOO#
OOO#OVO#OOO#OVO#OOO#OVO#OOO#
############################
OOO#OVO OVO#OOO OVO#OVO OOO#
OOO#OVO OVO#OOO OVO#OVO OOO#
OOO#OVO$OVO#OOO$OVO#OVO$OOO#
############################
OVO OOO#OVO OOO#OVO OOO#OVO#
OVO OOO#OVO OOO#OVO OOO#OVO#
OVO$OOO#OVO$OOO#OVO$OOO#OVO#
#$###$###$###$###$###$###$##
OOO#OOO#OOO#OOO#OOO#OOO#OOO#
OOO#OOO#OOO#OOO#OOO#OOO#OOO#
OOO#OOO#OOO#OOO#OOO#OOO#OOO#
