$E    XX    !$!   E      P $
#~~~~~X~X~~~~#~~~~XX~~~~~~~#
#~~~~$X~~X~~~#~~~~X~X~~~~~~#
#~~~XXX~~~~~~#~~~$X~~X~~~~~#
#~~~XXX~~~~~~#~~XXX~~~~~~~~#
#~~~~~~~~~~~~#~~XXX~~~~~~~~#
#E   $$$     E            E#
#            $         $$  #
#~~~~~~~~~~~~#~~~~~~~~~XX~~#
#~~~~~~~~XX~~#~~~~~~~~~X~X~#
#~~~~~~~~X~X~#~~~~~~~~$X~~X#
#~~~~~~~$X~~X#~~~~~~~XXX~~~#
#~~~~~~XXX~~~~~~~~~~~XXX~~~#
#      XXX        $$$      #
#                          #
#$$$$$$$$$$$$$$$$$$$$$$$$$$#
