OOOOOOOOOOOOOOOOOOOOOOOOOOO!
OOOO~~~~~~~~O~~~~~~~~~    O!
OOO     P   O    E    #O  O!
OOO   OOOO  OOOOOOOOO #O  O!
OO   OOOOO  OOO$OO$OO #O  O!
OO     $OO  O$OOOOO$O #O  O!
O    E      OOO$OOOO$ #O  O!
O   OOOO    O$OOOO$OO #O  O!
OVOOOOOOXX  OOO$O$OOO #O  O!
OVO$$$$$O## O$OOOOO$O #O  O!
OVOOOOOO## OOOO$OOOO$ #O  O!
OVOOOO    OOO$OOOO$OO #V  O!
OVOOOO#O OOOOOOOOOOOO #OOOO!
O     # O OOO         #O  O!
O    # OOO O          #O $O!
OOOOOOOOOOO OOOOOOOOOOOOOV!!
