#~~~~~~~~~~~~~~~~ EOOOO ~~~~
#~~~~~ E ~~~~~~~ OOOOOOO ~~~
#~~~  OOO  ~~~~ OOOOOOOO ~~~
#~~ OOOOOOO  ~ OOOOOOO  ~~~~
#~ O  OOOOOOO OOOOOO   ~~~~~
#~ O $ OOOOOOOOOOOO OOOOO ~~
#~~ OOO OOOOOOOOOO OOOOOOOO 
#~~~~~~~ OOOOOOOOOO OOOOOOOO
#       OOOOOOOOOOOO OOOOOOO
#      OOO$OOO$OOOOOO OOOOOO
#      OOOOOOOOOOOOOO OOOOOO
#   ~~~~~OOOOOOOO~~~~~OOOOOO
#    ~~~~OO   OOO~~~~~~OOOOO
#~~ OOO!OOOO#OOOOO OOOO OOOO
#  O$OO!  OOOOOO  OOOOOO OOO
#P#V#OOO!        OO#O#OO OOO
