OOOOOOOOOO########OOOOOOOOOO
OOOOOOO####EE   P####OOOOOOO
OOOOOO##   OOOOOO   ##OOOOOO
OOOOO## OOOOO~OOOOOO ##OOOOO
OOOO## OOOOOO~~O O$OO ##OOOO
OOO## OO$OOOO~~OOOOOOO ##OOO
OOO# OOOOE   ~~   EOOOO #OOO
OOO# OOOOOOOO~~OOOOOOOO #OOO
OOO# OOOOO~~O~~O~~OOOOO #OOO
OOO# OOOO~~OO~~OO~~OOOO #OOO
OOO## OO~ OO ~~OOO$~OO ##OOO
OOOO## OOOOOO ~OOOOOO ##OOOO
OOOOO## OOOOOO OOOOO ##OOOOO
OOOOOO##   OOOOOO   ##OOOOOO
OOOOOOO####      ####OOOOOOO
OOOOOOOOOO########OOOOOOOOOO
