##########$######P###      !
#####################X     !
#####################X     !
$#####E####$#########XOOOOOO
####XXXXXXXXXXXXXXXXXXXXXXXX
############################
#####$########E##$##########
XXXXXXXXXXXXXXXXXXXXXXXX####
########$##########$###X###$
#######################X####
#######################X####
####$#########$#######$X$###
####XXXXXXXXXXXXXX#####X####
#################X##########
###########E#$#$#X##########
XXXXXXXXXXXXXXXOXX#$#######$
