 !!~~~!~~~!~~~!~~~!~~~!~~~!!
 #OOVOOOVOOOVOOOVOOOVOOOVOO#
 #O~~~O   O~~ O ~~O   O~~~O#
 #OVOVOVOVOVOVOVOOOOOVOVOVO#
 #O    O~~~O   O   V~~~O  O#
 #OOVOVOVOVOVOVOVOOOVOVOVOO#
 #O   O   O~~~O~~~O   O   O#
 #OVOVOVOOOVOVOVOVOVOVOVOVO#
 #O  V  #O~~~O~~~O   O   OO#
 #OOVVVOVOVOVOVOVOOOOOVOVOO#
 #O   O~~~O   V   O#~~O   O#
 #OVOVOVOVOVOVVOOOOOOVOVOVO#
 #O~~~ O   O   O#  O   O~~O#
 #OOVOVOVOVOVVVVVOVOVOVOVOO#
 #PEE         $         EEE#
 OOOOOOOOOOOO! !OOOOOOOOOOOO
