# ~ E  E  E  E   ~  ~  ~ P~#
#O OO$OO$OO$OO$OO OO OO OO #
#OO OO OO OO OO OO OO OO OO#
# OO OO OO OO OO OO OO OO O#
#O OO OO OO OO OO OO OO OO #
#OO OO OO OO OO OO OO OO OO#
# OO OO OO OO OO OO OO OO O#
#O OO OO OO OO OO OO OO OO #
#OO OO OO OO OO OO OO OO OO#
# OO OO OO OO OO OO OO OO O#
#O OO OO OO OO OO OO OO OO #
#OO OO OO OO OO OO OO OO OO#
# OO$OO$OO$OO$OO$OO$OO$OO$O#
#O OO OO OO OO OO OO OO OO #
#                          #
OOOOOOOOOOOOOOOOOOOOOOOOOOOO
