OOOOOOOOOOOOOOOOOOOOOOOOOOO 
OOOOOOOOOOOOOOOOOOOOOOOOOOO!
P             $ O          !
#XOXOXOXOXOXO O OOOOOOOOOOO#
#XOXOXOXOXOXOXO O OOOOOOO O#
#            $  O OOOOOOO O#
#OXOXOXOXOXO O  O O~OOO~O O#
#OXOXOXOXOXOXO  O O~OOO~O O#
#           $   O O~O O~O O#
#XOXOXOXOXO O   O O~O O~O O#
#XOXOXOXOXOXO   O O~O O~O O#
#          $    O O~O O~O O#
#OXOXOXOXO O    O$O$O$O$O$O#
#OXOXOXOXOXO    OVOOOOOOOOO#
#                      EEEE#
#OOOOOOOOOOO    OOOOOOOOOOOO
